SO ./path_to_the_south_texture
NO ./path_to_the_north_texture
WE ./path_to_the_west_texture
EA ./path_to_the_east_texture

F 255,233,232
C 255,255,234


111111111111111111111111111
100000000000000000000000001
111111111111111111100000001
110000000000000000000000001
10000000000000E000000000001
100000000000000000000000001
111111111111111111111111111