SO ./path_to_the_south_texture
NO ./path_to_the_north_texture
WE ./path_to_the_west_texture
EA ./path_to_the_east_texture

F 255,220,255
C 225,30,0

11111111111111111111111111111111111111111111111111111111111111111111
10000000000000000000000000000N00000000000000000000000000000000000001
11111111111111111111111111111111111111111111111111111111111111111111