

SO ./textures/bluewall1.xpm
EA ./textures/brick1.xpm











NO ./textures/wall2.xpm
WE ./textures/wall4.xpm
C 42,42,42
F 255,0,123

1111111111111111111111111111111111
1000000000000000000000000000000001
1000000000000000000000000000000001111111111111111111111111111111111111111111111111111111111
1000000000000000000000000000000000000000000000000000000000000000000000000000000000000000001
10000E0000000000000000000000000000000000000000000000000000000000000000000000000000000000001
1000000000000000000000000000000001111111111111111111111111111111111111111111111111111111111
1000000000000001110000000000111111
1000000000000001 100000000011
1000000000000001 10000000001
1111111111111111 111111111111
