SO                      ./textures/brick1.xpm







EA ./textures/bluewall1.xpm


NO ./textures/wall2.xpm

WE ./textures/wall4.xpm

C      42,42,42

F 100,100,100

                111111111111111111111111111111111111111111111111111111111111111111111111111111111111111111111111111
                100000000000000000000000000000000000000000000000000000000000000000000000000000000000000000000000001
1111111111111111111000000011111111111111111000000011111111111111111000000011111111111111111000000011111111111111111
110000000000000000000000000000000000000000000000000000000000000000000000000000000000000000000000001
100000000000000000000000000000000000000000000000000000000000000000000000000000000000000000000000001
100000000000000000000000000000000000000000000000000000000000000000000000000000000000000000000000001
100000000000000000000000000000000000000000000000000000000000000000000000000000000000000000000000001
111111111111111111100000001111111111111111100000001111111111111111100000001111111111111111100000001
110000000000000000000000000000000000000000000000000000000000000000000000000000000000000000000000001
100000000000000000000000000000000000000000000000000000000000000000000000000000000000000000000000001
100000000000000000000000000000000000000000000000000000000000000000000000000000000000000000000000001
111111111111111111100000001111111111111111100000001111111111111111100000001111111111111111100000001
110000000000000000000000000000000000000000000000000000000000000000000000000000000000000000000000001
100000000000000000000000000000000000000000000000000000000000000000000000000000000000000000000000001
100000000000000000000000000000000000000000000000000000000000000000000000000000000000000000000000001
100000000000000000000000000000000000000000000000000000000000000000000000000000000000000000000000001
111111111111111111100000001111111111111111100000001111111111111111100000001111111111111111100000001
110000000000000000000000000000000000000000000000000000000000000000000000000000000000000000000000001
100000000000000000000000000000000000000000000000000000000000000000000000000000000000000000000000001
10000000000000000000000000000000000000000000000S000000000000000000000000000000000000000000000000001
100000000000000000000000000000000000000000000000000000000000000000000000000000000000000000000000001
111111111111111111100000001111111111111111100000001111111111111111100000001111111111111111100000001
110000000000000000000000000000000000000000000000000000000000000000000000000000000000000000000000001
100000000000000000000000000000000000000000000000000000000000000000000000000000000000000000000000001
100000000000000000000000000000000000000000000000000000000000000000000000000000000000000000000000001
100000000000000000000000000000000000000000000000000000000000000000000000000000000000000000000000001
111111111111111111100000001111111111111111100000001111111111111111100000001111111111111111100000001
111111111111111111111111111111111111111111111110000000000000000000000000000000000000000000000000001
                                              10000000000000000000000000000000000000000000000000001
                                              10000000000000000000000000000000000000000000000000011
111111111111111111111111111111111111111111111110000000000000000000000000000000000000000000000000001
111111111111111111100000001111111111111111100000001111111111111111100000001111111111111111100000001
110000000000000000000000000000000000000000000000000000000000000000000000000000000000000000000000001
100000000000000000000000000000000000000000000000000000000000000000000000000000000000000000000000001
100000000000000000000000000000000000000000000000000000000000000000000000000000000000000000000000001
100000000000000000000000000000000000000000000000000000000000000000000000000000000000000000000000001
111111111111111111111111111111111111111111111111111111111111111111111111111111111111111111111111111
