SO ./path_to_the_south_texture
NO ./path_to_the_north_texture
WE ./path_to_the_west_texture
EA ./path_to_the_east_texture

F 255,220,255
C 225,30,0

        1111111111111111111111111       1111111111
        1000000000110000000000001       1000000001
        1011000001110000000000001       1111111111
        1001000000N00000000000001
111111111011000001110000000000001
100000000011000001110111111111111
11110111111111011100000010001
11110111111111011101010010001
11000000110101011100000010001
1000000011111000110N000010001
100000001   10001101010010001
1100000111111101111101111000111
11110111 1110101 101111010001
11111111 1111111 111111111111