SO ./textures/brick1.xpm
EA ./textures/brick1.xpm
NO ./textures/brick1.xpm
WE ./textures/brick1.xpm

C 255,255,234
F 255,233,232

11111111111111
10000000000001
1000001110000111111111111111111111111111111111
10000000000000000000000000000N0000000000000001
1000000000000111111110000000000000000000000011
1111111111111111111111111111111111111111111111