SO ./path_to_the_south_texture
NO ./path_to_the_north_texture
WE ./path_to_the_west_texture
EA ./path_to_the_east_texture

F 255,220,255
C 225,30,0

111111111111111111111111111   111111111
100000000000000000000000001   100000001
100011111111111000000000001111111111111
110000000000000000000000001
100000000011111110000000001
111111110000000000000S00001
111111111111111111111111111