SO ./textures/bluewall1.xpm
EA                  ./textures/bluewall1.xpm
NO ./textures/wall2.xpm
WE ./textures/bluewall1.xpm
C 42,42,42
F 100,100,45
F 100,100,45


                11111111111111111111111111111111111111111
                10000000000000000000000000000000000000001
111111111111111111100000001111111000000011111111111111111
11000000000000000000000000000000000000001
11111111111111111111111000000000000000001
                      1000000W00000000001
                      1000000000000000011
11111111111111111111111000000000000000001
11111111111111111110000000111111100000001
11000000000000000000000000000000000000001
10000000000000000000000000000000000000001
10000000000000000000000000000000000000001
10000000000000000000000000000000000000001
11111111111111111111111111111111111111111